
 F     120,255,255    
WE   ./maps/textures/we.xpm



                  NO       ./maps/textures/no.xpm        
SO    ./maps/textures/so.xpm

EA   ./maps/textures/ea.xpm         

C     255,     122     , 0





         
11111111111111111111111111111111111111111111  111
1100011100000000000000000000000000001 101101  111
1000000000000100000000000000000000000110000111111
1000000000100000000000000000000000000110000111111
100000000000110000000N000000000000000110000111111              
1000000000000100000000000000000000000110000111111
1000000000000100000000000000000000000110000111111     
1000000000000100000000000000000000000110000111111
1110111000000000111111000000000000000000000001111
   1   111000111111  1000000000000000000000000001
1111111110011100000111000000000000000001111111111
1111000000000100000111100000000000000000000001111
11111111111111111111111100000111110011111111111111
111111   11111111   1111111111 1111111111111111111
      
         
           
             